10O#@
OOOOOO##OO
OOOOOOOOOO
OOOOOOOOOO
OOO#OOOOOO
OOOOOOOO#O
OOO#OOOOOO
OOOOOOOOOO
OOOOOOOOOO
OOOOOOOOOO
OOOOOOOOOO